11111111111111111111
10000000000444000001
10004400044444444001
10044440444444440001
10444440000000000001
10000000000000000001
10000000444000440001
11111100044004440001
13333100000004440001
13333100400004000001
10000000440000000001
12222100440000000001
12222100440000000001
12222100000000000001
11111111111111111111
