11111111111111111111
10000000000000000001
10000000000000000001
10000000000000000001
10000000000000000001
10000000000000000001
10000000000000000001
11111100000000000001
13333100000000000001
13333100000000000001
10000000000000000001
12222100000000000001
12222100000000000001
12222100000000000001
11111111111111111111
